00, 03, 04, 05, 00, 00, 00, 00, 00, 00, 00, 00
01, 02, 00, 06, 00, 00, 00, 00, 00, 00, 00, 00
00, 00, 00, 07, 00, 00, 00, 00, 00, 00, 00, 00
00, 00, 00, 08, 00, 00, 00, 00, 00, 00, 00, 00
00, 00, 00, 09, 00, 00, 00, 00, 00, 21, 22, 23
00, 00, 00, 10, 00, 00, 00, 00, 00, 20, 00, 24
00, 00, 00, 11, 00, 15, 16, 17, 18, 19, 00, 25
00, 00, 00, 12, 13, 14, 00, 00, 00, 00, 27, 26
00, 00, 00, 00, 00, 00, 00, 00, 00, 00, 28, 00
00, 00, 00, 00, 00, 00, 00, 00, 00, 00, 29, 30