00, 00, 00, 00, 00, 00, 00, 00, 00, 00, 00, 00
01, 02, 00, 00, 00, 12, 13, 14, 15, 00, 00, 00
00, 03, 00, 00, 00, 11, 00, 00, 16, 00, 00, 00
00, 04, 00, 00, 00, 10, 00, 18, 17, 00, 00, 00
00, 05, 06, 07, 08, 09, 00, 19, 00, 00, 00, 00
00, 00, 00, 00, 00, 00, 00, 20, 00, 00, 00, 00
00, 00, 00, 00, 00, 00, 00, 21, 00, 00, 00, 00
00, 00, 00, 00, 00, 00, 00, 22, 00, 00, 00, 00
00, 00, 00, 00, 00, 00, 00, 23, 00, 00, 00, 00
00, 00, 00, 00, 00, 00, 00, 24, 25, 26, 27, 28